1111111111
1P011E0001
1001111001
1001C00001
10000000C1
1111111111